NO ./textures/gray.xpm
WE ./textures/purple.xpm
SO ./textures/red.xpm
EA ./textures/yellow.xpm

F 000,000,000
C 000,000, 000
  
1110011111111111111
1001110001000000001
1000000000100000001
100000W000000000001
1000000000010000001
1000000000100000001
1111111111111111111