NO  ./sprites/xpm_images/cra.xpm
SO  ./sprites/xpm_images/craa.xpm
WE  ./sprites/xpm_images/cra.xpm
EA  ./sprites/xpm_images/craa.xpm

F 000,000,000
C 000,000,000
  
1101111110111111111
1010000001000000001
1000000000100000001
100000E000000000001
1000000000010000001
1000000000100000001
1111111111111111111