NO  ./sprites/xpm_images/cra.xpm
SO  ./sprites/xpm_images/craa.xpm
WE  ./sprites/xpm_images/cra.xpm
EA  ./sprites/xpm_images/craa.xpm

F 000,000,000
C 000,000,000
  
1111111110111111111
1000000001000000001
1000000000100000011
100000E000000000100
1000000000010000011
1000000000100000001
1111111111111111111