NO ./textures/Alexanderplatz_station.xpm
WE ./textures/Alexanderplatz_station.xpm
SO ./textures/Alexanderplatz_station.xpm
EA ./textures/Alexanderplatz_station.xpm

F 143,142,133
C 196,195,181
    1111111
    1000001
    1000001
    1000001
    1000001
    1000001
    1000001
    100S001
    1000011
    11111111
       1
