NO ./textures/gray.xpm
WE ./textures/purple.xpm
SO ./textures/red.xpm
EA ./textures/yellow.xpm

F 135,125,100
C 109,158,173

  
1111111111111111111
1000000001000000001
1000000000100000011
100000N000000000101
1000000000010000011
1000000000100000001
1111111111111111111