NO ./textures/gray.xpm
WE ./textures/purple.xpm
SO ./textures/red.xpm
EA ./textures/yellow.xpm

F 135,125,100
C 109,158,173

  
 11111111111111111
1000000001000000001
1000000000100000001
100000S000000000001
1000000000010000001
1000000000100000001
 11111111111111111