NO ./textures/gray.xpm
WE ./textures/purple.xpm
SO ./textures/red.xpm
EA ./textures/yellow.xpm

F 135,125,100
C 109,158,173

# Map (25x13)
1111111111111111111111111
1000000000110000000000001
1011000001110000000000001
1001000000000000000000001
1111111110110000011100001
1000000000110000011101111
1111011111111101110000001
1111011111111101110101001
1100000011010101110000001
1000000000000000110000001
1000000000000000110101001
1100000111010101111101111
1111011111111111111111111