NO ./textures/gray.xpm
WE ./textures/purple.xpm
SO ./textures/red.xpm
EA ./textures/yellow.xpm

F 135,125,100
C 109,158,173


11101111111111111111
10000010000000100001
10001100000000010001
10000100000000001001
1010000000E000000001
11111111111111111111
