NO ./textures/Alexanderplatz_station.xpm
WE ./textures/Alexanderplatz_station.xpm
SO ./textures/Alexanderplatz_station.xpm
EA ./textures/Alexanderplatz_station.xpm

F 143,142,133
C 196,195,181
  
1111011111111111111
1000110001000000001
1000000000100000001
100000W00000000011
100000000010000001
1000000000100000001
1111111111111111111